info{
rowcount:48
colcount:48
camerapos:Translation: X=5211.569 Y=10129.112 Z=208.000 Rotation: P=-4.563960 Y=-46.946762 R=0.000000 Scale X=1.000 Y=1.000 Z=1.000
cameraangle:0,45,0
biome:ice
creator:DDI
}
tiles{
38,38,38,38,38,38,38,38,38,38,38,38,38,38,38,38,38,38,38,38,38,38,38,38,38,38,38,38,38,38,38,38,38,38,38,38,38,38,38,38,38,38,38,38,38,38,38,38,
38,38,38,38,38,38,38,38,38,38,38,38,38,38,38,38,38,38,38,38,38,38,38,38,38,38,38,38,38,38,38,38,38,38,38,38,38,38,38,38,38,38,38,38,38,38,38,38,
38,38,38,38,38,38,38,38,38,38,38,38,38,38,38,38,38,38,38,38,38,38,38,38,38,38,38,38,38,38,38,38,38,38,38,38,38,38,38,38,38,38,38,38,38,38,38,38,
38,38,38,38,38,38,38,38,38,38,38,38,38,38,38,38,38,38,38,38,34,34,38,38,38,38,38,38,38,38,38,38,38,38,38,38,38,38,38,38,38,38,38,38,38,38,38,38,
38,38,38,38,38,38,38,38,38,38,38,38,38,38,38,38,38,38,38,38,101,101,30,30,30,30,30,30,38,38,38,38,38,38,38,38,38,38,38,38,38,38,38,38,38,38,38,38,
38,38,38,38,38,38,38,38,38,38,38,38,38,38,38,38,38,38,38,111,101,111,38,38,38,38,26,101,38,38,38,38,38,38,38,38,38,38,38,38,38,38,38,38,38,38,38,38,
38,38,38,38,38,38,38,38,38,38,38,38,38,38,38,38,38,38,111,111,101,111,111,38,38,38,38,101,101,38,38,38,38,38,38,38,38,38,38,38,38,38,38,38,38,38,38,38,
38,38,38,38,38,38,38,38,38,38,38,38,38,38,38,38,38,111,111,101,101,101,111,38,38,38,38,101,101,38,38,38,38,38,38,38,38,38,38,38,38,38,38,38,38,38,38,38,
38,38,38,38,38,38,38,38,38,38,38,38,101,38,38,38,111,111,101,101,26,101,111,111,38,38,38,101,101,38,38,38,38,38,38,38,38,38,38,38,38,38,38,38,38,38,38,38,
38,38,38,38,38,38,38,38,38,38,38,101,101,101,38,111,111,111,101,26,101,101,111,111,38,38,38,26,101,101,38,38,38,38,38,38,38,38,38,38,38,38,38,38,38,38,38,38,
38,38,38,38,38,38,101,38,38,38,30,101,101,101,38,111,111,111,111,101,101,111,111,111,38,38,38,38,101,101,101,38,38,38,38,38,38,38,38,38,38,38,38,38,38,38,38,38,
38,38,38,38,38,101,101,101,38,38,101,101,38,38,38,38,111,111,111,111,111,111,111,111,38,38,38,38,26,101,101,38,38,38,38,38,38,38,38,38,38,38,38,38,38,38,38,38,
38,38,38,38,26,101,101,101,101,101,101,38,38,38,38,38,111,111,111,111,111,111,111,38,38,38,38,38,38,30,101,101,38,38,38,38,38,38,38,38,38,38,38,38,38,38,38,38,
38,38,38,38,26,101,46,38,101,101,38,38,38,38,38,38,38,111,111,111,111,111,38,38,38,38,38,38,38,38,30,38,38,38,38,38,38,38,38,38,38,38,38,38,38,38,38,38,
38,38,38,38,26,101,38,38,38,38,38,42,38,38,38,38,38,38,111,111,111,38,38,38,38,38,38,38,38,38,30,38,38,38,38,38,38,38,38,38,38,38,38,38,38,38,38,38,
38,38,38,38,30,30,38,38,42,38,38,30,38,38,38,38,38,38,101,101,101,38,38,38,42,38,38,38,26,101,101,38,38,38,38,38,38,38,38,38,38,38,38,38,38,38,38,38,
38,38,38,34,101,101,101,101,101,101,34,34,34,38,38,38,38,38,38,38,38,38,38,38,30,38,38,26,26,101,101,101,38,38,38,38,38,38,38,38,38,38,38,38,38,38,38,38,
38,38,38,38,38,38,30,101,101,101,26,101,101,26,26,38,38,38,38,101,38,30,30,30,30,30,30,101,101,101,101,38,38,38,38,38,38,38,38,38,38,38,38,38,38,38,38,38,
38,38,38,38,38,38,30,101,34,34,34,34,101,101,101,26,34,38,38,101,101,26,101,101,101,101,101,101,101,101,38,38,38,38,38,38,38,38,38,38,38,38,38,38,38,38,38,38,
38,38,38,38,38,38,30,101,34,38,38,38,38,101,101,101,101,38,38,38,101,26,30,30,30,30,30,30,30,101,38,38,38,38,38,38,38,38,38,38,38,38,38,38,38,38,38,38,
38,38,38,38,38,30,101,101,38,38,38,38,38,101,38,101,101,38,38,38,101,38,38,38,38,38,38,38,30,101,38,38,38,38,38,38,38,38,38,38,38,38,38,38,38,38,38,38,
38,38,38,38,38,26,26,26,38,38,38,38,38,42,38,34,101,101,101,101,101,38,38,38,38,38,38,38,30,101,101,38,38,38,38,38,38,38,38,38,38,38,38,38,38,38,38,38,
38,38,38,38,38,38,26,101,26,38,38,38,38,38,38,34,34,101,101,101,38,38,38,38,38,38,38,30,101,101,38,38,38,38,38,38,38,38,38,38,38,38,38,38,38,38,38,38,
38,38,38,38,38,38,26,101,101,26,38,38,38,38,38,34,30,101,101,38,38,38,38,38,38,30,30,101,101,38,38,38,38,38,38,38,38,38,38,38,38,38,38,38,38,38,38,38,
38,38,38,38,38,38,38,101,101,101,38,38,38,38,38,34,30,26,26,38,38,38,38,38,38,30,30,101,30,38,38,38,38,38,38,38,38,38,111,111,38,38,38,38,38,38,38,38,
38,38,38,38,38,38,38,38,101,101,26,38,38,38,38,34,30,1,1,26,42,38,38,38,30,30,101,101,30,30,38,38,38,38,38,38,38,38,111,111,38,38,38,38,38,38,38,38,
38,38,38,38,38,38,38,38,101,26,26,46,38,38,38,34,38,38,1,38,38,38,38,38,30,101,101,101,30,30,38,38,38,38,38,38,38,111,111,111,38,38,38,38,38,38,38,38,
38,38,38,38,38,38,38,26,101,101,101,38,38,38,34,34,38,38,1,38,38,38,38,38,30,30,101,101,30,30,30,42,38,38,38,38,38,111,111,38,38,38,38,38,38,38,38,38,
38,38,38,38,38,38,38,26,101,101,101,38,38,34,34,38,38,38,63,26,30,38,38,38,38,30,30,30,30,38,38,38,38,38,38,38,111,111,111,38,38,38,38,38,38,38,38,38,
38,38,38,38,38,38,30,101,101,101,101,38,38,34,30,38,50,1,63,26,30,38,38,38,38,38,38,30,38,38,38,38,38,38,38,38,111,111,38,38,38,38,38,38,38,38,38,38,
38,38,38,38,38,38,101,101,101,101,101,38,38,30,38,38,38,1,63,63,26,30,38,38,38,38,38,42,38,38,38,38,38,38,38,111,111,111,38,38,38,38,38,38,38,38,38,38,
38,38,38,38,38,38,38,30,101,101,38,38,30,30,38,38,1,1,1,63,26,30,38,38,38,38,38,38,38,38,38,38,38,38,38,111,111,38,38,38,38,38,38,38,38,38,38,38,
38,38,38,38,38,38,38,38,38,38,38,38,30,38,38,1,1,1,1,63,63,26,30,38,38,30,30,30,30,38,38,38,38,101,111,111,111,38,38,38,38,38,38,38,38,38,38,38,
38,38,38,38,38,38,38,38,38,38,38,38,30,38,1,1,1,14,1,1,63,63,26,30,34,34,34,34,34,34,34,114,114,101,111,111,101,38,38,38,38,38,38,38,38,38,38,38,
38,38,38,38,38,38,38,38,38,38,38,38,38,38,38,1,1,14,1,1,1,63,26,30,34,34,34,34,34,34,34,101,114,101,111,111,101,101,38,38,38,38,38,38,38,38,38,38,
38,38,38,38,38,38,38,38,38,38,38,38,38,38,38,38,1,1,1,1,63,63,38,38,38,30,30,30,30,38,38,101,101,101,111,111,101,101,38,38,38,38,38,38,38,38,38,38,
38,38,38,38,38,38,38,38,38,38,38,38,38,38,38,38,38,46,38,46,38,50,38,38,38,38,38,38,38,38,38,38,101,101,111,111,101,101,38,38,38,38,38,38,38,38,38,38,
38,38,38,38,38,38,38,38,38,38,38,38,38,38,38,38,38,38,38,38,38,38,38,38,38,38,38,38,38,38,38,38,38,38,111,111,111,38,38,38,38,38,38,38,38,38,38,38,
38,38,38,38,38,38,38,38,38,38,38,38,38,38,38,38,38,38,38,38,38,38,38,38,38,38,38,38,38,38,38,38,38,38,38,111,111,111,111,111,38,38,38,38,38,38,38,38,
38,38,38,38,38,38,38,38,38,38,38,38,38,38,38,38,38,38,38,38,38,38,38,38,38,38,38,38,38,38,38,38,38,38,38,38,111,111,111,111,38,38,38,38,38,38,38,38,
38,38,38,38,38,38,38,38,38,38,38,38,38,38,38,38,38,38,38,38,38,38,38,38,38,38,38,38,38,38,38,38,38,38,38,38,38,38,38,38,38,38,38,38,38,38,38,38,
38,38,38,38,38,38,38,38,38,38,38,38,38,38,38,38,38,38,38,38,38,38,38,38,38,38,38,38,38,38,38,38,38,38,38,38,38,38,38,38,38,38,38,38,38,38,38,38,
38,38,38,38,38,38,38,38,38,38,38,38,38,38,38,38,38,38,38,38,38,38,38,38,38,38,38,38,38,38,38,38,38,38,38,38,38,38,38,38,38,38,38,38,38,38,38,38,
38,38,38,38,38,38,38,38,38,38,38,38,38,38,38,38,38,38,38,38,38,38,38,38,38,38,38,38,38,38,38,38,38,38,38,38,38,38,38,38,38,38,38,38,38,38,38,38,
38,38,38,38,38,38,38,38,38,38,38,38,38,38,38,38,38,38,38,38,38,38,38,38,38,38,38,38,38,38,38,38,38,38,38,38,38,38,38,38,38,38,38,38,38,38,38,38,
38,38,38,38,38,38,38,38,38,38,38,38,38,38,38,38,38,38,38,38,38,38,38,38,38,38,38,38,38,38,38,38,38,38,38,38,38,38,38,38,38,38,38,38,38,38,38,38,
38,38,38,38,38,38,38,38,38,38,38,38,38,38,38,38,38,38,38,38,38,38,38,38,38,38,38,38,38,38,38,38,38,38,38,38,38,38,38,38,38,38,38,38,38,38,38,38,
38,38,38,38,38,38,38,38,38,38,38,38,38,38,38,38,38,38,38,38,38,38,38,38,38,38,38,38,38,38,38,38,38,38,38,38,38,38,38,38,38,38,38,38,38,38,38,38,
}
height{
253,253,253,253,253,253,253,253,253,253,253,253,253,253,253,253,253,253,253,253,253,253,253,230,230,207,230,253,253,253,253,253,253,253,230,207,184,184,184,184,184,0,0,0,0,0,0,0,0,
230,230,230,230,230,230,230,230,230,230,253,253,253,253,253,230,230,230,230,230,230,230,230,230,207,207,230,253,253,276,276,276,276,253,230,207,184,184,184,184,184,0,0,0,0,0,0,0,0,
230,230,230,230,230,230,230,230,230,230,230,230,230,230,230,230,207,207,207,207,207,207,207,207,207,207,230,230,253,276,276,300,276,253,230,207,207,184,184,184,184,0,0,0,0,0,0,0,0,
207,207,207,207,207,207,207,207,207,207,207,207,230,230,207,207,207,184,184,184,184,184,184,184,184,207,207,230,253,253,276,300,276,253,230,230,207,184,184,184,207,0,0,0,0,0,0,0,0,
230,230,230,230,230,230,230,230,230,230,230,207,207,230,207,184,184,184,161,161,161,161,161,161,184,184,207,230,230,253,276,300,276,253,253,230,207,207,184,207,207,0,0,0,0,0,0,0,0,
253,253,253,253,253,253,253,253,253,253,230,207,207,207,207,184,161,161,161,138,138,138,138,161,161,184,207,207,230,253,276,300,276,276,253,230,230,207,207,207,230,0,0,0,0,0,0,0,0,
276,276,276,276,276,276,276,276,276,253,230,230,207,207,184,184,161,161,138,138,138,138,138,138,161,184,184,207,230,253,276,276,300,276,253,253,230,230,207,230,230,0,0,0,0,0,0,0,0,
300,300,300,300,300,300,300,300,276,253,230,207,207,184,184,161,161,138,138,138,161,161,138,138,161,161,184,207,230,253,253,276,276,276,276,253,253,230,230,230,230,0,0,0,0,0,0,0,0,
300,300,323,323,323,323,323,300,276,253,230,207,207,184,161,161,138,138,138,138,161,161,138,138,138,161,184,207,230,230,253,253,276,300,276,276,253,230,230,230,230,0,0,0,0,0,0,0,0,
300,300,323,346,346,346,323,300,276,253,230,207,207,184,161,138,138,138,138,161,161,161,138,138,138,161,184,207,230,230,253,253,276,276,300,276,253,230,230,230,230,0,0,0,0,0,0,0,0,
300,300,323,346,369,346,323,300,276,253,230,230,207,184,161,138,138,138,138,138,161,138,138,138,138,161,184,207,230,230,253,276,276,276,300,276,253,230,230,230,230,0,0,0,0,0,0,0,0,
323,323,323,346,346,346,323,300,276,253,230,230,207,184,161,138,138,138,138,138,138,138,138,138,138,161,184,207,207,230,253,253,253,276,276,276,253,230,230,230,230,0,0,0,0,0,0,0,0,
323,323,346,346,323,323,323,300,276,253,230,230,207,184,161,161,138,138,138,138,138,138,138,138,138,161,184,207,207,230,230,230,253,253,253,253,253,230,230,230,230,0,0,0,0,0,0,0,0,
323,323,346,323,323,300,300,300,276,253,230,230,207,184,184,161,138,138,138,138,138,138,138,138,161,161,184,207,230,230,230,253,253,253,276,253,230,230,230,230,230,0,0,0,0,0,0,0,0,
323,323,346,323,323,323,300,276,276,253,230,230,207,184,184,161,161,138,138,138,138,138,138,161,161,184,184,207,230,230,253,253,276,276,276,253,230,230,230,230,253,0,0,0,0,0,0,0,0,
323,323,346,346,346,323,300,276,253,253,230,230,207,207,184,184,161,161,138,138,138,138,161,161,184,184,207,207,230,253,253,276,276,300,276,253,253,253,230,253,253,0,0,0,0,0,0,0,0,
323,323,346,369,346,323,300,276,253,230,230,207,207,207,207,184,184,161,161,161,161,161,161,184,184,207,207,230,230,253,276,276,300,276,276,276,276,253,253,253,230,0,0,0,0,0,0,0,0,
323,323,346,346,346,323,300,276,253,230,230,230,230,230,207,207,184,184,184,184,184,184,184,184,207,207,207,230,253,253,276,300,300,300,276,276,276,253,253,230,230,0,0,0,0,0,0,0,0,
346,346,346,346,323,323,300,276,253,253,253,253,253,230,230,207,207,207,207,207,207,207,207,207,207,207,207,230,253,276,276,300,276,276,276,253,253,253,230,230,207,0,0,0,0,0,0,0,0,
346,346,369,346,346,323,300,276,253,276,276,276,253,253,230,230,207,207,207,207,207,207,207,207,207,207,207,230,253,276,300,300,276,253,253,253,253,230,230,207,207,0,0,0,0,0,0,0,0,
346,346,346,369,346,323,300,276,253,276,300,276,276,253,253,230,207,207,207,207,207,207,207,230,230,230,207,230,253,276,300,276,276,253,230,230,230,230,207,207,207,0,0,0,0,0,0,0,0,
346,346,346,369,346,323,300,276,253,276,276,300,276,276,253,230,207,207,207,207,230,230,230,230,253,230,207,230,253,276,300,276,253,253,230,230,230,230,230,230,230,0,0,0,0,0,0,0,0,
346,346,369,369,346,323,300,276,253,253,276,276,300,276,253,230,207,207,207,207,230,253,253,253,253,230,207,230,253,276,276,276,253,230,230,230,253,253,253,253,253,0,0,0,0,0,0,0,0,
346,346,346,369,346,323,300,276,253,253,253,276,276,276,253,230,207,207,207,207,230,253,276,253,230,230,230,230,253,276,276,253,253,230,230,230,253,276,276,276,276,0,0,0,0,0,0,0,0,
323,323,346,369,346,323,300,276,253,253,253,253,253,253,253,230,230,207,207,207,230,253,253,253,230,230,253,253,253,276,276,253,230,230,230,253,253,276,253,253,253,0,0,0,0,0,0,0,0,
323,323,346,369,346,323,300,276,276,253,253,230,253,276,253,253,230,207,207,207,230,253,230,230,230,253,253,276,276,276,253,253,230,230,230,253,276,276,253,253,253,0,0,0,0,0,0,0,0,
323,323,346,369,346,323,300,300,276,276,253,230,253,253,276,253,230,207,207,207,230,230,230,230,253,253,276,276,276,276,253,230,230,230,253,253,276,253,253,253,253,0,0,0,0,0,0,0,0,
323,323,346,346,346,323,323,300,300,276,253,230,253,253,276,253,230,207,207,207,207,230,253,230,253,276,276,300,276,253,253,230,230,230,253,276,276,253,253,253,253,0,0,0,0,0,0,0,0,
323,323,323,323,346,346,323,323,300,276,253,253,253,276,253,253,230,207,207,207,207,230,230,230,253,276,300,276,276,253,230,230,230,253,253,276,253,253,253,253,276,0,0,0,0,0,0,0,0,
300,300,300,323,346,346,346,323,300,276,253,253,276,276,276,253,230,207,207,207,207,207,207,230,253,276,276,276,253,253,230,230,230,253,276,276,253,253,253,253,276,0,0,0,0,0,0,0,0,
276,276,300,323,346,369,346,323,300,276,253,253,276,300,276,253,230,207,207,207,207,207,207,230,253,253,276,253,253,230,230,230,253,253,276,253,253,253,253,276,276,0,0,0,0,0,0,0,0,
276,276,300,323,346,346,346,323,300,276,253,253,276,276,276,253,230,207,207,207,207,207,207,230,230,253,253,253,230,230,230,230,253,276,276,253,253,253,253,276,253,0,0,0,0,0,0,0,0,
276,276,300,323,323,323,323,323,300,276,253,253,253,253,253,253,230,207,207,207,207,207,207,207,230,230,253,253,230,230,230,253,253,276,253,253,253,253,276,276,253,0,0,0,0,0,0,0,0,
276,276,300,323,300,300,300,300,300,276,253,253,230,230,230,230,230,207,207,207,207,207,207,207,207,230,230,230,230,230,253,253,276,276,253,253,253,253,276,253,253,0,0,0,0,0,0,0,0,
276,276,300,300,300,300,276,276,276,276,276,253,230,207,207,207,207,207,207,207,207,207,207,207,207,207,207,230,230,230,253,276,276,276,253,253,253,276,276,253,230,0,0,0,0,0,0,0,0,
276,276,276,276,276,276,300,300,300,300,276,253,230,230,230,207,207,207,207,207,207,207,207,207,207,207,207,230,230,230,253,276,276,276,253,253,253,276,253,253,230,0,0,0,0,0,0,0,0,
253,253,253,253,253,276,300,323,323,300,276,253,253,253,230,230,207,207,207,207,207,207,207,207,207,207,207,230,230,230,253,276,276,276,253,253,253,276,276,253,253,0,0,0,0,0,0,0,0,
230,230,230,230,253,276,300,300,300,300,276,253,276,253,253,230,207,207,207,207,230,230,230,230,230,230,230,230,230,230,253,253,276,276,23,23,23,23,276,276,276,0,0,0,0,0,0,0,0,
207,207,207,230,253,276,276,276,276,276,276,253,253,276,253,230,207,207,230,230,230,253,253,253,230,253,230,230,230,230,253,276,276,23,23,23,23,23,23,23,23,0,0,0,0,0,0,0,0,
184,184,207,230,253,253,253,253,253,253,253,253,253,253,253,230,230,230,230,253,253,253,276,253,253,230,230,230,230,230,253,276,276,23,23,23,23,23,23,23,23,0,0,0,0,0,0,0,0,
184,184,207,230,230,230,230,230,230,230,230,230,230,230,230,230,207,207,230,230,230,253,253,253,230,230,207,207,207,230,253,276,276,23,23,23,23,23,23,23,23,0,0,0,0,0,0,0,0,
0,0,0,0,0,0,0,0,0,0,0,0,0,0,0,0,0,0,0,0,0,0,0,0,0,0,0,0,0,0,0,0,0,0,0,0,0,0,0,0,0,0,0,0,0,0,0,0,0,
0,0,0,0,0,0,0,0,0,0,0,0,0,0,0,0,0,0,0,0,0,0,0,0,0,0,0,0,0,0,0,0,0,0,0,0,0,0,0,0,0,0,0,0,0,0,0,0,0,
0,0,0,0,0,0,0,0,0,0,0,0,0,0,0,0,0,0,0,0,0,0,0,0,0,0,0,0,0,0,0,0,0,0,0,0,0,0,0,0,0,0,0,0,0,0,0,0,0,
0,0,0,0,0,0,0,0,0,0,0,0,0,0,0,0,0,0,0,0,0,0,0,0,0,0,0,0,0,0,0,0,0,0,0,0,0,0,0,0,0,0,0,0,0,0,0,0,0,
0,0,0,0,0,0,0,0,0,0,0,0,0,0,0,0,0,0,0,0,0,0,0,0,0,0,0,0,0,0,0,0,0,0,0,0,0,0,0,0,0,0,0,0,0,0,0,0,0,
0,0,0,0,0,0,0,0,0,0,0,0,0,0,0,0,0,0,0,0,0,0,0,0,0,0,0,0,0,0,0,0,0,0,0,0,0,0,0,0,0,0,0,0,0,0,0,0,0,
0,0,0,0,0,0,0,0,0,0,0,0,0,0,0,0,0,0,0,0,0,0,0,0,0,0,0,0,0,0,0,0,0,0,0,0,0,0,0,0,0,0,0,0,0,0,0,0,0,
0,0,0,0,0,0,0,0,0,0,0,0,0,0,0,0,0,0,0,0,0,0,0,0,0,0,0,0,0,0,0,0,0,0,0,0,0,0,0,0,0,0,0,0,0,0,0,0,0,
}
resources{
crystals:
0,0,0,0,0,0,0,0,0,0,0,0,0,0,0,0,0,0,0,0,0,0,0,0,0,0,0,0,0,0,0,0,0,0,0,0,0,0,0,0,0,0,0,0,0,0,0,0,
0,0,0,0,0,0,0,0,0,0,0,0,0,0,0,0,0,0,0,0,0,0,0,0,0,0,0,0,0,0,0,0,0,0,0,0,0,0,0,0,0,0,0,0,0,0,0,0,
0,0,0,0,0,0,0,0,0,0,0,0,0,0,0,0,0,0,0,0,0,0,0,0,0,0,0,0,0,0,0,0,0,0,0,0,0,0,0,0,0,0,0,0,0,0,0,0,
0,0,0,0,0,0,0,0,0,0,0,0,0,0,0,0,0,0,0,0,0,0,0,0,0,0,0,0,0,0,0,0,0,0,0,0,0,0,0,0,0,0,0,0,0,0,0,0,
0,0,0,0,0,0,0,0,0,0,0,0,0,0,0,0,0,0,0,0,0,0,3,0,0,3,0,3,0,0,0,0,0,0,0,0,0,0,0,0,0,0,0,0,0,0,0,0,
0,0,0,0,0,0,0,0,0,0,0,0,0,0,0,0,0,0,0,0,0,0,0,0,0,0,3,0,0,0,0,0,0,0,0,0,0,0,0,0,0,0,0,0,0,0,0,0,
0,0,0,0,0,0,0,0,0,0,0,0,0,0,0,0,0,0,0,0,0,0,0,0,0,0,0,0,0,0,0,0,0,0,0,0,0,0,0,0,0,0,0,0,0,0,0,0,
0,0,0,0,0,0,0,0,0,0,0,0,0,0,0,0,0,0,0,0,0,0,0,0,0,0,0,0,0,0,0,0,0,0,0,0,0,0,0,0,0,0,0,0,0,0,0,0,
0,0,0,0,0,0,0,0,0,0,0,0,0,0,0,0,0,0,0,0,25,0,0,0,0,0,0,0,0,0,0,0,0,0,0,0,0,0,0,0,0,0,0,0,0,0,0,0,
0,0,0,0,0,0,0,0,0,0,0,0,0,0,0,0,0,0,0,25,0,0,0,0,0,0,0,0,0,0,0,0,0,0,0,0,0,0,0,0,0,0,0,0,0,0,0,0,
0,0,0,0,0,0,0,0,0,0,0,0,0,0,0,0,0,0,0,0,0,0,0,0,0,0,0,0,0,0,0,0,0,0,0,0,0,0,0,0,0,0,0,0,0,0,0,0,
0,0,0,0,0,0,0,0,0,0,0,0,0,0,0,0,0,0,0,0,0,0,0,0,0,0,0,0,0,0,0,0,0,0,0,0,0,0,0,0,0,0,0,0,0,0,0,0,
0,0,0,0,3,0,0,0,0,0,0,0,0,0,0,0,0,0,0,0,0,0,0,0,0,0,0,0,0,0,0,0,0,0,0,0,0,0,0,0,0,0,0,0,0,0,0,0,
0,0,0,0,0,0,0,0,0,0,0,0,0,0,0,0,0,0,0,0,0,0,0,0,0,0,0,0,0,0,3,0,0,0,0,0,0,0,0,0,0,0,0,0,0,0,0,0,
0,0,0,0,0,0,0,0,0,0,0,0,0,0,0,0,0,0,0,0,0,0,0,0,0,0,0,0,0,0,0,0,0,0,0,0,0,0,0,0,0,0,0,0,0,0,0,0,
0,0,0,0,0,0,0,0,0,0,0,0,0,0,0,0,0,0,0,0,0,0,0,0,0,0,0,0,0,0,0,0,0,0,0,0,0,0,0,0,0,0,0,0,0,0,0,0,
0,0,0,3,0,0,0,0,0,0,0,0,3,0,0,0,0,0,0,0,0,0,0,0,0,0,0,0,0,0,0,0,0,0,0,0,0,0,0,0,0,0,0,0,0,0,0,0,
0,0,0,0,0,0,0,0,0,0,0,0,0,0,0,0,0,0,0,0,0,3,0,0,0,0,0,0,0,0,0,0,0,0,0,0,0,0,0,0,0,0,0,0,0,0,0,0,
0,0,0,0,0,0,0,0,0,0,0,3,0,0,0,0,0,0,0,0,0,0,0,0,0,0,0,0,0,0,0,0,0,0,0,0,0,0,0,0,0,0,0,0,0,0,0,0,
0,0,0,0,0,0,0,0,0,0,0,0,0,0,0,0,0,0,0,0,0,0,0,3,0,0,0,0,0,0,0,0,0,0,0,0,0,0,0,0,0,0,0,0,0,0,0,0,
0,0,0,0,0,0,0,0,0,0,0,0,0,0,0,0,0,0,0,0,0,0,0,0,0,0,0,0,0,0,0,0,0,0,0,0,0,0,0,0,0,0,0,0,0,0,0,0,
0,0,0,0,0,3,0,0,0,0,0,0,0,0,0,0,0,0,0,0,0,0,0,0,0,0,0,0,0,0,0,0,0,0,0,0,0,0,0,0,0,0,0,0,0,0,0,0,
0,0,0,0,0,0,0,0,0,0,0,0,0,0,0,0,0,0,0,0,0,0,0,0,0,0,0,0,0,0,0,0,0,0,0,0,0,0,0,0,0,0,0,0,0,0,0,0,
0,0,0,0,0,0,0,0,0,0,0,0,0,0,0,0,0,0,0,0,0,0,0,0,0,3,0,0,0,0,0,0,0,0,0,0,0,0,0,0,0,0,0,0,0,0,0,0,
0,0,0,0,0,0,0,0,0,0,0,0,0,0,0,0,0,0,0,0,0,0,0,0,0,0,0,0,3,0,0,0,0,0,0,0,0,0,0,0,0,0,0,0,0,0,0,0,
0,0,0,0,0,0,0,0,0,0,3,0,0,0,0,3,0,0,0,0,0,0,0,0,0,0,0,0,0,0,0,0,0,0,0,0,0,0,0,0,0,0,0,0,0,0,0,0,
0,0,0,0,0,0,0,0,0,0,0,0,0,0,0,0,0,0,0,0,0,0,0,0,0,0,0,0,3,0,0,0,0,0,0,0,0,0,0,0,0,0,0,0,0,0,0,0,
0,0,0,0,0,0,0,3,0,0,0,0,0,0,3,0,0,0,0,0,0,0,0,0,0,0,0,0,0,3,0,0,0,0,0,0,0,0,0,0,0,0,0,0,0,0,0,0,
0,0,0,0,0,0,0,0,0,0,0,0,0,0,0,0,0,0,0,1,0,0,0,0,0,3,0,0,0,0,0,0,0,0,0,0,0,0,0,0,0,0,0,0,0,0,0,0,
0,0,0,0,0,0,0,0,0,0,0,0,0,3,3,0,0,0,0,0,0,0,0,0,0,0,3,0,0,0,0,0,0,0,0,0,0,0,0,0,0,0,0,0,0,0,0,0,
0,0,0,0,0,0,0,0,0,0,0,0,0,0,0,0,0,0,0,0,0,0,0,0,0,0,0,0,0,0,0,0,0,0,0,0,0,0,0,0,0,0,0,0,0,0,0,0,
0,0,0,0,0,0,0,0,0,0,0,0,0,3,0,0,0,0,0,0,1,0,0,0,0,0,0,0,0,0,0,0,0,0,0,0,0,0,0,0,0,0,0,0,0,0,0,0,
0,0,0,0,0,0,0,0,0,0,0,0,0,0,0,0,0,0,0,0,0,1,0,0,0,0,0,0,3,0,0,0,0,0,0,0,0,0,0,0,0,0,0,0,0,0,0,0,
0,0,0,0,0,0,0,0,0,0,0,0,0,0,0,0,0,0,0,0,0,0,0,0,3,0,0,3,0,0,0,0,0,0,0,0,0,0,0,0,0,0,0,0,0,0,0,0,
0,0,0,0,0,0,0,0,0,0,0,0,0,0,0,0,0,0,0,0,0,0,0,0,3,0,0,0,0,3,0,0,0,0,0,0,0,0,0,0,0,0,0,0,0,0,0,0,
0,0,0,0,0,0,0,0,0,0,0,0,0,0,0,0,0,0,0,0,0,1,0,0,0,0,3,0,0,0,0,0,0,0,0,0,0,0,0,0,0,0,0,0,0,0,0,0,
0,0,0,0,0,0,0,0,0,0,0,0,0,0,0,0,0,0,0,0,0,0,0,0,0,0,0,0,0,0,0,0,0,0,0,0,0,0,0,0,0,0,0,0,0,0,0,0,
0,0,0,0,0,0,0,0,0,0,0,0,0,0,0,0,0,0,0,0,0,0,0,0,0,0,0,0,0,0,0,0,0,0,0,0,0,0,0,0,0,0,0,0,0,0,0,0,
0,0,0,0,0,0,0,0,0,0,0,0,0,0,0,0,0,0,0,0,0,0,0,0,0,0,0,0,0,0,0,0,0,0,0,0,0,0,0,0,0,0,0,0,0,0,0,0,
0,0,0,0,0,0,0,0,0,0,0,0,0,0,0,0,0,0,0,0,0,0,0,0,0,0,0,0,0,0,0,0,0,0,0,0,0,0,0,0,0,0,0,0,0,0,0,0,
0,0,0,0,0,0,0,0,0,0,0,0,0,0,0,0,0,0,0,0,0,0,0,0,0,0,0,0,0,0,0,0,0,0,0,0,0,0,0,0,0,0,0,0,0,0,0,0,
0,0,0,0,0,0,0,0,0,0,0,0,0,0,0,0,0,0,0,0,0,0,0,0,0,0,0,0,0,0,0,0,0,0,0,0,0,0,0,0,0,0,0,0,0,0,0,0,
0,0,0,0,0,0,0,0,0,0,0,0,0,0,0,0,0,0,0,0,0,0,0,0,0,0,0,0,0,0,0,0,0,0,0,0,0,0,0,0,0,0,0,0,0,0,0,0,
0,0,0,0,0,0,0,0,0,0,0,0,0,0,0,0,0,0,0,0,0,0,0,0,0,0,0,0,0,0,0,0,0,0,0,0,0,0,0,0,0,0,0,0,0,0,0,0,
0,0,0,0,0,0,0,0,0,0,0,0,0,0,0,0,0,0,0,0,0,0,0,0,0,0,0,0,0,0,0,0,0,0,0,0,0,0,0,0,0,0,0,0,0,0,0,0,
0,0,0,0,0,0,0,0,0,0,0,0,0,0,0,0,0,0,0,0,0,0,0,0,0,0,0,0,0,0,0,0,0,0,0,0,0,0,0,0,0,0,0,0,0,0,0,0,
0,0,0,0,0,0,0,0,0,0,0,0,0,0,0,0,0,0,0,0,0,0,0,0,0,0,0,0,0,0,0,0,0,0,0,0,0,0,0,0,0,0,0,0,0,0,0,0,
0,0,0,0,0,0,0,0,0,0,0,0,0,0,0,0,0,0,0,0,0,0,0,0,0,0,0,0,0,0,0,0,0,0,0,0,0,0,0,0,0,0,0,0,0,0,0,0,
ore:
0,0,0,0,0,0,0,0,0,0,0,0,0,0,0,0,0,0,0,0,0,0,0,0,0,0,0,0,0,0,0,0,0,0,0,0,0,0,0,0,0,0,0,0,0,0,0,0,
0,0,0,0,0,0,0,0,0,0,0,0,0,0,0,0,0,0,0,0,0,0,0,0,0,0,0,0,0,0,0,0,0,0,0,0,0,0,0,0,0,0,0,0,0,0,0,0,
0,0,0,0,0,0,0,0,0,0,0,0,0,0,0,0,0,0,0,0,0,0,0,0,0,0,0,0,0,0,0,0,0,0,0,0,0,0,0,0,0,0,0,0,0,0,0,0,
0,0,0,0,0,0,0,0,0,0,0,0,0,0,0,0,0,0,0,0,3,3,0,0,0,0,0,0,0,0,0,0,0,0,0,0,0,0,0,0,0,0,0,0,0,0,0,0,
0,0,0,0,0,0,0,0,0,0,0,0,0,0,0,0,0,0,0,0,0,0,0,3,3,0,3,0,0,0,0,0,0,0,0,0,0,0,0,0,0,0,0,0,0,0,0,0,
0,0,0,0,0,0,0,0,0,0,0,0,0,0,0,0,0,0,0,0,0,0,0,0,0,0,0,0,0,0,0,0,0,0,0,0,0,0,0,0,0,0,0,0,0,0,0,0,
0,0,0,0,0,0,0,0,0,0,0,0,0,0,0,0,0,0,0,0,0,0,0,0,0,0,0,0,0,0,0,0,0,0,0,0,0,0,0,0,0,0,0,0,0,0,0,0,
0,0,0,0,0,0,0,0,0,0,0,0,0,0,0,0,0,0,0,0,0,0,0,0,0,0,0,0,0,0,0,0,0,0,0,0,0,0,0,0,0,0,0,0,0,0,0,0,
0,0,0,0,0,0,0,0,0,0,0,0,0,0,0,0,0,0,0,0,0,0,0,0,0,0,0,0,0,0,0,0,0,0,0,0,0,0,0,0,0,0,0,0,0,0,0,0,
0,0,0,0,0,0,0,0,0,0,0,0,0,0,0,0,0,0,0,0,0,0,0,0,0,0,0,1,0,0,0,0,0,0,0,0,0,0,0,0,0,0,0,0,0,0,0,0,
0,0,0,0,0,0,0,0,0,0,0,0,0,0,0,0,0,0,0,0,0,0,0,0,0,0,0,0,0,0,0,0,0,0,0,0,0,0,0,0,0,0,0,0,0,0,0,0,
0,0,0,0,0,0,0,0,0,0,1,0,0,0,0,0,0,0,0,0,0,0,0,0,0,0,0,0,3,0,0,0,0,0,0,0,0,0,0,0,0,0,0,0,0,0,0,0,
0,0,0,0,0,0,0,0,0,0,0,0,1,0,0,0,0,0,0,0,0,0,0,0,0,0,0,0,0,1,0,0,0,0,0,0,0,0,0,0,0,0,0,0,0,0,0,0,
0,0,0,0,1,0,0,0,0,0,0,0,0,0,0,0,0,0,0,0,0,0,0,0,0,0,0,0,0,0,0,0,0,0,0,0,0,0,0,0,0,0,0,0,0,0,0,0,
0,0,0,0,0,0,0,0,0,0,0,0,0,0,0,0,0,0,0,0,0,0,0,0,0,0,0,0,0,0,3,0,0,0,0,0,0,0,0,0,0,0,0,0,0,0,0,0,
0,0,0,0,0,3,1,0,0,0,0,0,0,0,0,0,0,0,0,0,0,0,0,0,0,0,0,0,0,0,0,0,0,0,0,0,0,0,0,0,0,0,0,0,0,0,0,0,
0,0,0,0,0,0,0,0,0,0,1,0,0,0,0,0,0,0,0,0,0,0,0,0,0,0,0,0,3,0,0,0,0,0,0,0,0,0,0,0,0,0,0,0,0,0,0,0,
0,0,0,0,0,0,0,0,0,0,0,0,0,1,1,0,0,0,0,0,0,0,1,1,0,1,0,0,0,0,0,0,0,0,0,0,0,0,0,0,0,0,0,0,0,0,0,0,
0,0,0,0,0,0,3,0,0,1,1,0,0,0,0,1,1,0,0,0,0,0,0,0,0,0,0,0,0,0,0,0,0,0,0,0,0,0,0,0,0,0,0,0,0,0,0,0,
0,0,0,0,0,0,0,0,0,0,0,0,0,0,0,0,0,0,0,0,0,0,1,0,1,0,1,3,0,0,0,0,0,0,0,0,0,0,0,0,0,0,0,0,0,0,0,0,
0,0,0,0,0,1,0,0,0,0,0,0,0,0,0,0,0,0,0,0,0,0,0,0,0,0,0,0,1,0,0,0,0,0,0,0,0,0,0,0,0,0,0,0,0,0,0,0,
0,0,0,0,0,0,0,0,0,0,0,0,0,0,0,0,0,0,0,0,0,0,0,0,0,0,0,0,0,0,0,0,0,0,0,0,0,0,0,0,0,0,0,0,0,0,0,0,
0,0,0,0,0,0,1,0,0,0,0,0,0,0,0,0,1,0,0,0,0,0,0,0,0,0,0,3,0,0,0,0,0,0,0,0,0,0,0,0,0,0,0,0,0,0,0,0,
0,0,0,0,0,0,3,0,0,3,0,0,0,0,0,1,1,0,0,0,0,0,0,0,0,0,0,0,0,0,0,0,0,0,0,0,0,0,0,0,0,0,0,0,0,0,0,0,
0,0,0,0,0,0,0,0,0,0,0,0,0,0,0,1,1,0,0,0,0,0,0,0,0,0,3,0,0,0,0,0,0,0,0,0,0,0,0,0,0,0,0,0,0,0,0,0,
0,0,0,0,0,0,0,0,0,0,0,0,0,0,0,0,1,0,0,0,0,0,0,0,1,0,0,0,3,0,0,0,0,0,0,0,0,0,0,0,0,0,0,0,0,0,0,0,
0,0,0,0,0,0,0,0,0,0,3,3,0,0,0,1,0,0,0,0,0,0,0,0,1,0,0,0,0,0,0,0,0,0,0,0,0,0,0,0,0,0,0,0,0,0,0,0,
0,0,0,0,0,0,0,0,0,0,0,0,0,0,0,1,0,0,0,0,0,0,0,0,0,3,0,0,1,0,0,0,0,0,0,0,0,0,0,0,0,0,0,0,0,0,0,0,
0,0,0,0,0,0,0,3,0,0,0,0,0,3,3,1,0,0,0,0,1,0,0,0,0,0,3,0,3,0,0,0,0,0,0,0,0,0,0,0,0,0,0,0,0,0,0,0,
0,0,0,0,0,0,3,0,0,0,0,0,0,0,0,0,0,0,0,1,1,0,0,0,0,0,0,3,0,0,0,0,0,0,0,0,0,0,0,0,0,0,0,0,0,0,0,0,
0,0,0,0,0,0,0,0,0,0,0,0,0,3,0,0,0,0,0,0,1,1,0,0,0,0,0,0,0,0,0,0,0,0,0,0,0,0,0,0,0,0,0,0,0,0,0,0,
0,0,0,0,0,0,0,3,0,0,0,0,3,0,0,0,0,0,0,0,0,1,0,0,0,0,0,0,0,0,0,0,0,0,0,0,0,0,0,0,0,0,0,0,0,0,0,0,
0,0,0,0,0,0,0,0,0,0,0,0,3,0,0,0,0,0,0,0,0,0,1,0,0,0,0,0,0,0,0,0,0,0,0,0,0,0,0,0,0,0,0,0,0,0,0,0,
0,0,0,0,0,0,0,0,0,0,0,0,3,0,0,0,0,0,0,0,0,0,1,1,0,0,0,0,0,0,0,0,0,0,0,0,0,0,0,0,0,0,0,0,0,0,0,0,
0,0,0,0,0,0,0,0,0,0,0,0,0,0,0,0,0,0,0,0,0,0,1,1,0,0,0,0,0,0,0,0,0,0,0,0,0,0,0,0,0,0,0,0,0,0,0,0,
0,0,0,0,0,0,0,0,0,0,0,0,0,0,0,0,0,0,0,0,0,0,0,0,0,0,0,0,0,0,0,0,0,0,0,0,0,0,0,0,0,0,0,0,0,0,0,0,
0,0,0,0,0,0,0,0,0,0,0,0,0,0,0,0,0,1,1,0,0,0,0,0,0,0,0,0,0,0,0,0,0,0,0,0,0,0,0,0,0,0,0,0,0,0,0,0,
0,0,0,0,0,0,0,0,0,0,0,0,0,0,0,0,0,0,0,0,0,0,0,0,0,0,0,0,0,0,0,0,0,0,0,0,0,0,0,0,0,0,0,0,0,0,0,0,
0,0,0,0,0,0,0,0,0,0,0,0,0,0,0,0,0,0,0,0,0,0,0,0,0,0,0,0,0,0,0,0,0,0,0,0,0,0,0,0,0,0,0,0,0,0,0,0,
0,0,0,0,0,0,0,0,0,0,0,0,0,0,0,0,0,0,0,0,0,0,0,0,0,0,0,0,0,0,0,0,0,0,0,0,0,0,0,0,0,0,0,0,0,0,0,0,
0,0,0,0,0,0,0,0,0,0,0,0,0,0,0,0,0,0,0,0,0,0,0,0,0,0,0,0,0,0,0,0,0,0,0,0,0,0,0,0,0,0,0,0,0,0,0,0,
0,0,0,0,0,0,0,0,0,0,0,0,0,0,0,0,0,0,0,0,0,0,0,0,0,0,0,0,0,0,0,0,0,0,0,0,0,0,0,0,0,0,0,0,0,0,0,0,
0,0,0,0,0,0,0,0,0,0,0,0,0,0,0,0,0,0,0,0,0,0,0,0,0,0,0,0,0,0,0,0,0,0,0,0,0,0,0,0,0,0,0,0,0,0,0,0,
0,0,0,0,0,0,0,0,0,0,0,0,0,0,0,0,0,0,0,0,0,0,0,0,0,0,0,0,0,0,0,0,0,0,0,0,0,0,0,0,0,0,0,0,0,0,0,0,
0,0,0,0,0,0,0,0,0,0,0,0,0,0,0,0,0,0,0,0,0,0,0,0,0,0,0,0,0,0,0,0,0,0,0,0,0,0,0,0,0,0,0,0,0,0,0,0,
0,0,0,0,0,0,0,0,0,0,0,0,0,0,0,0,0,0,0,0,0,0,0,0,0,0,0,0,0,0,0,0,0,0,0,0,0,0,0,0,0,0,0,0,0,0,0,0,
0,0,0,0,0,0,0,0,0,0,0,0,0,0,0,0,0,0,0,0,0,0,0,0,0,0,0,0,0,0,0,0,0,0,0,0,0,0,0,0,0,0,0,0,0,0,0,0,
0,0,0,0,0,0,0,0,0,0,0,0,0,0,0,0,0,0,0,0,0,0,0,0,0,0,0,0,0,0,0,0,0,0,0,0,0,0,0,0,0,0,0,0,0,0,0,0,
}
objectives{
building:BuildingSupportStation_C
resources: 50,100,0
}
buildings{
BuildingPowerStation_C
Translation: X=9750.000 Y=10050.000 Z=277.000 Rotation: P=0.000000 Y=-179.999954 R=0.000000 Scale X=1.000 Y=1.000 Z=1.000
Level=1
Teleport=False
Health=100.0
Powerpaths=X=28.000 Y=1.000 Z=0.000/X=27.000 Y=1.000 Z=7.000/X=28.000 Y=2.000 Z=0.000/
BuildingToolStore_C
Translation: X=5250.000 Y=10350.000 Z=208.000 Rotation: P=0.000000 Y=0.000000 R=0.000000 Scale X=1.000 Y=1.000 Z=1.000
Level=1
Teleport=False
Health=100.0
Powerpaths=X=26.000 Y=2.000 Z=1.000/X=26.000 Y=1.000 Z=1.000/
}
monsters{
}
monsterfrequency{
}
landslidefrequency{
}
lavaspread{
}
miners{
}
